NO res/redbrick.xpm
SO res/wood.xpm
WE res/graystone.xpm
EA res/bluestone.xpm

F 129,129,129
C 65,65,65

1111111111111111111
10000000000000000001
10000000000000000001
10001010101010101001
10000000000000000001
1000 000000000001001
100000000S0000001001
10000000000000001001
10000000000001111001
10000000000000000001
10000000000000000001
10000000000000000001
11111111111111111111
